000000000000
011111111110
A10000101000
010011111000
010010100110
011110111110
001000000010
B10110110110
011111101100
000101111000
000000000000